# # # # # # # # # # # # # # # # # # # # # # # # # # # # # # # # # # # # # # # # # # # #
# . . . . . . . . . . . . . . . . . . . . . . . . . . . . . . . . . . . . . . . . . . #
# . . . . . . . . . . . . . . . . . . . . . . . . . . . . . . . . . . . . . . . . . . #
# . . . . . . . . . . . . . . . . . . . . . . . . . . . . . . . . . . . . . . . . . . #
# . . . . . . . . # . . . . . . . . . . . . . . . . . . . . . . . . # . . . . . . . . #
# . . . . . . . . # . . . . . . . . . . . . . . . . . . . . . . . . # . . . . . . . . #
# . . . . . . # # # # # . . . . . . . . . . . . . . . . . . . . # # # # # . . . . . . #
# . . . . . . . . # . . . . . . . . . . . . . . . . . . . . . . . . # . . . . . . . . #
# . . . . . . . . # . . . . . . . . . . . . . . . . . . . . . . . . # . . . . . . . . #
# . . . . . . . . # . . . . . . . . . . . . . . . . . . . . . . . . # . . . . . . . . #
# . . . . . . . . # . . . . . . . . . . . . . . . . . . . . . . . . # . . . . . . . . #
# . . . . . . . . # . . . . . . . . . . . . . . . . . . . . . . . . # . . . . . . . . #
# . . . . . . . . # . . . . . . . . . . . . . . . . . . . . . . . . # . . . . . . . . #
# . . . . . . . . . . . . . . . . . . . . . . . . . . . . . . . . . . . . . . . . . . #
# . . . . . . . . . . . . . . . . . . . . . . . . . . . . . . . . . . . . . . . . . . #
# . . . . . . . . . . . . . . . . . . . . # . . . . . . . . . . . . . . . . . . . . . #
# . . . . . . . . . . . . . . . . . . . . # . . . . . . . . . . . . . . . . . . . . . #
# . . . . . . . . . . . . . . . . . . # # # # # . . . . . . . . . . . . . . . . . . . #
# . . . . . . . . . . . . . . . . . . . . # . . . . . . . . . . . . . . . . . . . . . #
# . . . . . . . . . . . . . . . . . . . . # . . . . . . . . . . . . . . . . . . . . . #
# . . . . . . . . . . . . . . . . . . . . # . . . . . . . . . . . . . . . . . . . . . #
# . . . . . . . . . . . . . . . . . . . . # . . . . . . . . . . . . . . . . . . . . . #
# . . . . . . . . . . . . . . . . . . . . # . . . . . . . . . . . . . . . . . . . . . #
# . . . . . . . . . . * . . . . . . . . . # . . . . . . . . . . . . . . . . . . . . . #
# . . . . . . . . . . . . . . . . . . . . . . . . . . . . . . . . . . . . . . . . . . #
# . . . . . . . . . . . . . . . . . . . . . . . . . . . . . . . . . . . . . . . . . . #
# # # # # # # # # # # # # # # # # # # # # # # # # # # # # # # # # # # # # # # # # # # #
