# # # # # # # # # # # # # # # # # # # # # # # # # # # # # # # # # # # # # # # # # # # #
# . . . . . . . . . . . . . . . . . . . . . . . . . . . . . . . . . . . . . . . . . . #
# . . . . . . . . . . . . . . . . . . . . . . . . . . . . . . . . . . . . . . . . . . #
# . . . . . . . . . . . . . . . . . . . . . . . . . . . . . . . . . . . . . . . . . . #
# . . . . # # # # . . . . . . . . . . . . . . . . . . . . . . . . . . # # # # . . . . #
# . . . . # . . . . . . . . . . . . # # # # # # # # . . . . . . . . . . . . # . . . . #
# . . . . # . . . . . . . . . . . . # . . . . . . # . . . . . . . . . . . . # . . . . #
# . . . . # . . . . . . . . . . . . # . . . . . . # . . . . . . . . . . . . # . . . . #
# . . . . . . . . . . . . . . . . . # . . . . . . # . . . . . . . . . . . . . . . . . #
# . . . . . . . . . . . . . . . . . . . . . . . . . . . . . . . . . . . . . . . . . . #
# . . . . . . . . . . . . . . . . . . . . . . . . . . . . . . . . . . . . . . . . . . #
# . . . . . . . . . . . . . . . . . . . * . . . . . . . . . . . . . . . . . . . . . . #
# . . . . . . . . . . . . . . . . . . . . . . . . . . . . . . . . . . . . . . . . . . #
# . . . . . . . . . . . . . . . . . . . . . . . . . . . . . . . . . . . . . . . . . . #
# . . . . . . . . . . . . . . . . . . . . . . . . . . . . . . . . . . . . . . . . . . #
# . . . . . . . . . . . . . . . . . . . . . . . . . . . . . . . . . . . . . . . . . . #
# . . . . . . . . . . . . . . . . . . . . . . . . . . . . . . . . . . . . . . . . . . #
# . . . . . . . . . . . . . . . . . # . . . . . . # . . . . . . . . . . . . . . . . . #
# . . . . . . . . . . . . . . . . . # . . . . . . # . . . . . . . . . . . . . . . . . #
# . . . . # . . . . . . . . . . . . # . . . . . . # . . . . . . . . . . . . # . . . . #
# . . . . # . . . . . . . . . . . . # # # # # # # # . . . . . . . . . . . . # . . . . #
# . . . . # . . . . . . . . . . . . . . . . . . . . . . . . . . . . . . . . # . . . . #
# . . . . # # # # . . . . . . . . . . . . . . . . . . . . . . . . . . # # # # . . . . #
# . . . . . . . . . . . . . . . . . . . . . . . . . . . . . . . . . . . . . . . . . . #
# . . . . . . . . . . . . . . . . . . . . . . . . . . . . . . . . . . . . . . . . . . #
# . . . . . . . . . . . . . . . . . . . . . . . . . . . . . . . . . . . . . . . . . . #
# # # # # # # # # # # # # # # # # # # # # # # # # # # # # # # # # # # # # # # # # # # #
