# # # # # # # # # # # # # # # # # # # # # # # # # # # # # # # # # # # # # # # # # # # #
# . . . . . . . . . . . . . . . . . . . . . . . . . . . . . . . . . . . . . . . . . . #
# . . . . . . . . . . . . . . . . . . . . . . . . . . . . . . . . . . . . . . . . . . #
# . . . . . . . . . . . . . . . . . . . . . . . . . . . . . . . . . . . . . . . . . . #
# . . . . . . # # # # # # # # . . . . . . . . . . . # # # # # # # # # . . . . . . . . #
# . . . . . . # . . . . . . . . . . . . . . . . . . # . . . . . . . . . . . . . . . . #
# . . . . . . # . . . . . . . . . . . . . . . . . . # . . . . . . . . . . . . . . . . #
# . . . . . . # . . . . . . . . . . . . . . . . . . # . . . . . . . . . . . . . . . . #
# . . . . . . # . . . . . . . . . . . . . . . . . . # . . . . . . . . . . . . . . . . #
# . . . . . . # . . . . . . . . . . . . . . . . . . # . . . . . . . . . . . . . . . . #
# . . . . . . # # # # # # # # . . . . . . . . . . . # # # # # # # # . . . . . . . . . #
# . . . . . . . . . . . . . # . . . . . . . . . . . # . . . . . . . . . . . . . . . . #
# . . . . . . . . . . . . . # . . . . . . . . . . . # . . . . . . . . . . . . . . . . #
# . . . . . . . . . . . . . # . . . . . . . . . . . # . . . . . . . . . . . . . . . . #
# . . . . . . . . . . . . . # . . . . . . . . . . . # . . . . . . . . . . . . . . . . #
# . . . . . . . . . . . . . # . . . . . . . . . . . # . . . . . . . . . . . . . . . . #
# . . . . . . # # # # # # # # . . . . . . . . . . . # # # # # # # # # . . . . . . . . #
# . . . . . . . . . . . . . . . . . . . . . . . . . . . . . . . . . . . . . . . . . . #
# . . . . . . . . . . . . . . . . . . . . . . . . . . . . . . . . . . . . . . . . . . #
# . . . . . . . . . . . . . . . . . . . . . . . . . . . . . . . . . . . . . . . . . . #
# . . . . . . . . . . . . . . . . . . . . . . . . . . . . . . . . . . . . . . . . . . #
# . . . . . . . . . . . * . . . . . . . . . . . . . . . . . . . . . . . . . . . . . . #
# . . . . # # # # # # # # # # # # # # # # # # # # # # # # # # # # # # # # # # . . . . #
# . . . . . . . . . . . . . . . . . . . . . . . . . . . . . . . . . . . . . . . . . . #
# . . . . . . . . . . . . . . . . . . . . . . . . . . . . . . . . . . . . . . . . . . #
# . . . . . . . . . . . . . . . . . . . . . . . . . . . . . . . . . . . . . . . . . . #
# # # # # # # # # # # # # # # # # # # # # # # # # # # # # # # # # # # # # # # # # # # #
